NO ./path_to_the_north_texture
SO ./path_to_the_south_texture
WE ./path_to_the_west_texture
EA ./path_to_the_east_texture
F 255,100,10
C 255,100,24

11111111111111111111111111111 1111111111
10000000000000000000000000001 10000000011111111
10000000000000000000000000001 10000000000000001
100000000000000000000000S0001 100000000000000011111111111              111111111111111111111111  
100000000000000000000000000011100000000000000000000000001              100000000000000000000001
100000000000000000000000000000000000000000000000000000001              100000000000000000000001
100000000000000000000000000011111111100000000000000000001              1000000000000000000000011111111
10000000000000000000000000001       100000000000000000001              1000000000000000000000000000001
10000000000000000000000000001 111111100000000000000000001              1000000000000000000000011111111
10000000000000000000000000001 10000000000000000000000000111111111111111100000000000000000000001
10000000000000000000000000001 10000000000000000000000000000000000000000000000000000000000000001
10000000000000000000000000001 10000000000000000000000000000000000000000000000000000000000000001
10000000000000000000000000001 10000000000000000000000000111111111111111100000000000000000000001
11111111111111111111111111111 100000000000000000000000001              100000000000000000000001
                              100000000000000000111111111              100000000000000001111101
                              111111111111111100111111111              111111111111111111111101
                                             1001                                           101
                              111111111111111100111111111                                   101
                              100000000000000000000000001                                   101
                              100000000000000000000000001                                   101
                              100000000000000000000000001                                   101
                              10000000000000000000000000111111111111111111111111111111111111101
                              10000000000000000000000000000000000000000000000000000000000000001
                              10000000000000000000000000000000000000000000000000000000000000001
                              10000000000000000000000000000000001111111100000000000000000000001
                              1000000000000000000000000000000001    100000000000000000000000001
                              10000000000000000000000000000000001111111100000000000000000000001
                              10000000000000000000000000000000000000000000000000000000000000001
                              11111111111111111111111111111111111111111111111111111111111111111
