NO ./path_to_the_north_texture
SO ./path_to_the_south_texture
WE ./path_to_the_west_texture
EA ./path_to_the_east_texture
F 220,100,0
C 225,30,0

111111111111111111111 1111111 111111
1000000000000001E11001 100001 100001
111111110111111111111 11111101011111
       101           111111000001
111111110111111111111111000000001
100000000000000000000000000000001
100000000000000000011111111111111
11111111111111111111